0 0  0  0  0  0  0 0 0  0  0  0  0  0 0 0  0  0 0 0 0
0 0  0  0  0  0  0 0 0  0  0  0  0  0 0 0  0  0 0 0 0
0 0 20  0  0  0 20 0 0 10 10 10 10 10 0 0  0  0 0 0 0
0 0 20  0  0  0 20 0 0  0  0  0  0 10 0 0  0  0 0 0 0
0 0 20  0  0  0 20 0 0  0  0  0  0 10 0 0  0  0 0 0 0
0 0 20 20 20 20 10 0 0 10 10 10 10 10 0 0 10 10 0 0 0
0 0  0  0  0  0 20 0 0 10  0  0  0  0 0 0 10 10 0 0 0 
0 0  0  0  0  0 20 0 0 10  0  0  0  0 0 0  0  0 0 0 0
0 0  0  0  0  0 20 0 0 10  0  0  0  0 0 0  0  0 0 0 0
0 0  0  0  0  0 20 0 0 10 10 10 10 10 0 0  0  0 0 0 0
0 0  0  0  0  0  0 0 0  0  0  0  0  0 0 0  0  0 0 0 0
0 0  0  0  0  0  0 0 0  0  0  0  0  0 0 0  0  0 0 0 0