 
                                  1000001
                                  1010101
                                  1000001
                                  1010101
                                  1000001
                                  1010101
                                  1000001
                                  1010101
     11111111111                  1000001
     10000000001                  1010101
     10200000201                  1000001
     10000000001                  1010101
     10000000001                  1000001
     10200000201                  1010101
     10000000001                  1000001
100000000000000000001                s
100000000000000000001                0
100000000000000000001                0
100000000000000000001                0
100000000000000000001               1s1
100000000000000000001               000
1000000000000000000011              000
10000000000000000000s0000000000000000001
10000000000000000000s0000000000000000001
1000000000*00000000011
111111111111111111111
